                        NO ./maps/texture/no.xpm               
      SO ./maps/texture/so.xpm
         EA ./maps/texture/ea.xpm
  WE ./maps/texture/e.xpm
C    1,        2,         3
F       4,         5,            8

1111111111111
   2111011111111111111
  3000000000101101011      
       4000000000E001101011      
    500000001011011111
          6000000000001101011     
       8000000000101101011111111
   9000000000101101011100001
   10000001000101101011100111
      2000000000000000000000001
      30000000P0010110101111111111111111111111111
  4000000000101101011      
    51000000000101101011      
   611111111111111111111111  