NO ./maps/texture/no.xpm
SO ./maps/texture/so.xpm
WE ./maps/texture/we.xpm
EA ./maps/texture/ea.xpm
C 1,20,2
F 4,50,12




1111011111111111111
1000000000101101011      
1000000000001101011      
1000E00001011011111
1000000000001101011      
1000000000101101011111111
1000000000101101011100001
10000001000101101011100111
1000000000000000000000001
100000000010110101111111111111111111111111
1000000000101101011      
1000000000101101011      
111111111111111111111111  